╔═════════════╕ ╒═════════════════════╕ ╒═════════════╗
║ · · · · · · │ │ · · · · · · · · · · │ │ · · · · · · ║
║ · ┌─────┐ · │ │ · ┌─────────────┐ · │ │ · ┌─────┐ · ║
║ ■ └─────┘ · └─┘ · └─────┐ ┌─────┘ · └─┘ · └─────┘ ■ ║
║ · · · · · · · · · · · · │ │ · · · · · · · · · · · · ║
║ · ┌───────────┐ · ┌─┐ · │ │ · ┌─┐ · ┌───────────┐ · ║
║ · │ ┌─────────┘ · │ │ · │ │ · │ │ · └─────────┐ │ · ║
║ · │ │ · · · · · · │ │ · └─┘ · │ │ · · · · · · │ │ · ║
║ · │ │ · ┌─────┐ · │ │ · · · · │ │ · ┌─────┐ · │ │ · ║
║ · └─┘ · └───┐ │ · │ └─────────┘ │ · │ ┌───┘ · └─┘ · ║
║ · · · · · · │ │ · └─────────────┘ · │ │ · · · · · · ║
╚═══╗ · ┌─┐ · │ │ · · · · · · · · · · │ │ · ┌─┐ · ╔═══╝
    ║ · │ │ · │ │ · ╔═════   ═════╗ · │ │ · │ │ · ║
════╝ · └─┘ · └─┘ · ║             ║ · └─┘ · └─┘ · ╚════
· · · · · · · · · · ║             ║ · · · · · · · · · ·
════╗ · ┌─┐ · ┌─┐ · ║             ║ · ┌─┐ · ┌─┐ · ╔════
    ║ · │ │ · │ │ · ╚═════════════╝ · │ │ · │ │ · ║
    ║ · │ │ · │ │ · · · · · · · · · · │ │ · │ │ · ║
    ║ · │ │ · │ └─────┐ · ┌─┐ · ┌─────┘ │ · │ │ · ║
╔═══╝ · └─┘ · └───────┘ · │ │ · └───────┘ · └─┘ · ╚═══╗
║ · · · · · · · · · · · · │ │ · · · · · · · · · · · · ║
║ · ┌─────────────────┐ · │ │ · ┌─────────────────┐ · ║
║ · └─────────┐ ┌─────┘ · └─┘ · └─────┐ ┌─────────┘ · ║
║ ■ · · · · · │ │ · · · · · · · · · · │ │ · · · · · ■ ║
╚═══╗ · ┌─┐ · │ │ · ┌─────────────┐ · │ │ · ┌─┐ · ╔═══╝
════╝ · │ │ · └─┘ · └─────┐ ┌─────┘ · └─┘ · │ │ · ╚════
· · · · │ │ · · · · · · · │ │ · · · · · · · │ │ · · · ·
════╗ · │ │ · ┌───────┐ · │ │ · ┌───────┐ · │ │ · ╔════
    ║ · └─┘ · └───────┘ · └─┘ · └───────┘ · └─┘ · ║
    ║ · · · · · · · · · · · · · · · · · · · · · · ║
    ╚═════════════════════════════════════════════╝