╔═════════════╕ ╒═════════════════════╕ ╒═════════════╗
║ · · · · · · │ │ · · · · · · · · · · │ │ · · · · · · ║
║ · ┌─────┐ · │ │ · ┌─────────────┐ · │ │ · ┌─────┐ · ║
║ ■ └─────┘ · └─┘ · └─────────────┘ · └─┘ · └─────┘ ■ ║
║ · · · · · · · · · · · · · · · · · · · · · · · · · · ║
║ · ┌─────┐ · ┌───────┐ · ┌─┐ · ┌───────┐ · ┌─────┐ · ║
║ · │     │ · │       │ · │ │ · │       │ · │     │ · ║
║ · └─────┘ · └───────┘ · │ │ · └───────┘ · └─────┘ · ║
║ · · · · · · · · · · · · │ │ · · · · · · · · · · · · ║
╚═════════╗ · ┌───────┐ · │ │ · ┌───────┐ · ╔═════════╝
          ║ · │ ┌─────┘ · └─┘ · └─────┐ │ · ║
          ║ · │ │ · · · · · · · · · · │ │ · ║
          ║ · │ │ · ╔═════   ═════╗ · │ │ · ║
══════════╝ · └─┘ · ║             ║ · └─┘ · ╚══════════
· · · · · · · · · · ║             ║ · · · · · · · · · ·
══════════╗ · ┌─┐ · ║             ║ · ┌─┐ · ╔══════════
          ║ · │ │ · ╚═════════════╝ · │ │ · ║
          ║ · │ │ · · · · · · · · · · │ │ · ║
          ║ · │ │ · ┌─────────────┐ · │ │ · ║
╔═════════╝ · └─┘ · └─────────────┘ · └─┘ · ╚═════════╗
║ · · · · · · · · · · · · · · · · · · · · · · · · · · ║
║ · ┌─────────────────┐ · ┌─┐ · ┌─────────────────┐ · ║
║ · └─────────┐ ┌─────┘ · └─┘ · └─────┐ ┌─────────┘ · ║
║ ■ · · · · · │ │ · · · · · · · · · · │ │ · · · · · ■ ║
╙───┐ · ┌─┐ · │ │ · ┌─────────────┐ · │ │ · ┌─┐ · ┌───╜
╓───┘ · │ │ · └─┘ · └─────────────┘ · └─┘ · │ │ · └───╖
║ · · · │ │ · · · · · · · · · · · · · · · · │ │ · · · ║
║ · ┌───┘ │ · ┌───────┐ · ┌─┐ · ┌───────┐ · │ └───┐ · ║
║ · └─────┘ · └───────┘ · └─┘ · └───────┘ · └─────┘ · ║
║ · · · · · · · · · · · · · · · · · · · · · · · · · · ║
╚═════════════════════════════════════════════════════╝