╔═════════════════════════╕ ╒═════════════════════════╗
╝ · · · · · · · · · · · · │ │ · · · · · · · · · · · · ╚
· · ┌─────┐ · ┌───────┐ · │ │ · ┌───────┐ · ┌─────┐ · · 
╗ ■ │     │ · │       │ · └─┘ · │       │ · │     │ ■ ╔
║   └─────┘ · └───────┘ · · · · └───────┘ · └─────┘ · ║
║ · · · · · · · · · · · · ┌─┐ · · · · · · · · · · · · ║
╝ · ┌─────┐ · ┌─┐ · ┌─────┘ └─────┐ · ┌─┐ · ┌─────┐ · ╚
· · └─────┘ · │ │ · └─────┐ ┌─────┘ · │ │ · └─────┘ · ·
╗ · · · · · · │ │ · · · · │ │ · · · · │ │ · · · · · · ╔
╚═╗ · ┌───┐ · │ └─────┐ · │ │ · ┌─────┘ │ · ┌───┐ · ╔═╝
  ║ · │   │ · │ ┌─────┘ · └─┘ · └─────┐ │ · │   │ · ║
  ║ · │   │ · └─┘ · · · · · · · · · · └─┘ · │   │ · ║  
  ║ · │   │ · · · · ╔═════   ═════╗ · · · · │   │ · ║ 
══╝ · └───┘ · ┌─┐ · ║             ║ · ┌─┐ · └───┘ · ╚══
· · · · · · · │ │ · ║             ║ · │ │ · · · · · · · 
══╗ · ┌───┐ · └─┘ · ║             ║ · └─┘ · ┌───┐ · ╔══
  ║ · │   │ · · · · ╚═════════════╝ · · · · │   │ · ║  
  ║ · │   │ · ┌─┐ · · · · · · · · · · ┌─┐ · │   │ · ║ 
  ║ · │   │ · │ │ · ┌─────────────┐ · │ │ · │   │ · ║ 
  ║ · └───┘ · └─┘ · └─────┐ ┌─────┘ · └─┘ · └───┘ · ║
══╝ · · · · · · · · · · · │ │ · · · · · · · · · · · ╚══
· · · ┌───┐ · ┌───────┐ · │ │ · ┌───────┐ · ┌───┐ · · ·
══╗ · └─┐ │ · └───────┘ · └─┘ · └───────┘ · │ ┌─┘ · ╔══
  ║ ■ · │ │ · · · · · · · · · · · · · · · · │ │ · ■ ║
  ╚═╗ · │ │ · ┌─┐ · ┌─────────────┐ · ┌─┐ · │ │ · ╔═╝
════╝ · └─┘ · │ │ · └─────┐ ┌─────┘ · │ │ · └─┘ · ╚════
· · · · · · · │ │ · · · · │ │ · · · · │ │ · · · · · · ·
╗ · ┌─┐ · ┌───┘ └─────┐ · │ │ · ┌─────┘ └───┐ · ┌─┐ · ╔
║ · └─┘ · └───────────┘ · └─┘ · └───────────┘ · └─┘ · ║
║ · · · · · · · · · · · · · · · · · · · · · · · · · · ║
╚═════════════════════════════════════════════════════╝