╔═════════════════════════╕ ╒═════════════════════════╗
║ · · · · · · · · · · · · │ │ · · · · · · · · · · · · ║
║ · ┌─────┐ · ┌───────┐ · │ │ · ┌───────┐ · ┌─────┐ · ║
║ ■ │     │ · │       │ · │ │ · │       │ · │     │ ■ ║
║ · └─────┘ · └───────┘ · └─┘ · └───────┘ · └─────┘ · ║
║ · · · · · · · · · · · · · · · · · · · · · · · · · · ║
║ · ┌─────┐ · ┌─┐ · ┌─────────────┐ · ┌─┐ · ┌─────┐ · ║
║ · └─────┘ · │ │ · └─────┐ ┌─────┘ · │ │ · └─────┘ · ║
║ · · · · · · │ │ · · · · │ │ · · · · │ │ · · · · · · ║
╚═════════╗ · │ └─────┐ · │ │ · ┌─────┘ │ · ╔═════════╝
          ║ · │ ┌─────┘ · └─┘ · └─────┐ │ · ║
          ║ · │ │ · · · · · · · · · · │ │ · ║
          ║ · │ │ · ╔═════   ═════╗ · │ │ · ║
══════════╝ · └─┘ · ║             ║ · └─┘ · ╚══════════
· · · · · · · · · · ║             ║ · · · · · · · · · ·
══════════╗ · ┌─┐ · ║             ║ · ┌─┐ · ╔══════════
          ║ · │ │ · ╚═════════════╝ · │ │ · ║
          ║ · │ │ · · · · · · · · · · │ │ · ║
          ║ · │ │ · ┌─────────────┐ · │ │ · ║
╔═════════╝ · └─┘ · └─────┐ ┌─────┘ · └─┘ · ╚═════════╗
║ · · · · · · · · · · · · │ │ · · · · · · · · · · · · ║
║ · ┌─────┐ · ┌───────┐ · │ │ · ┌───────┐ · ┌─────┐ · ║
║ · └───┐ │ · └───────┘ · └─┘ · └───────┘ · │ ┌───┘ · ║
║ ■ · · │ │ · · · · · · · · · · · · · · · · │ │ · · ■ ║
╙───┐ · │ │ · ┌─┐ · ┌─────────────┐ · ┌─┐ · │ │ · ┌───╜
╓───┘ · └─┘ · │ │ · └─────┐ ┌─────┘ · │ │ · └─┘ · └───╖
║ · · · · · · │ │ · · · · │ │ · · · · │ │ · · · · · · ║
║ · ┌─────────┘ └─────┐ · │ │ · ┌─────┘ └─────────┐ · ║
║ · └─────────────────┘ · └─┘ · └─────────────────┘ · ║
║ · · · · · · · · · · · · · · · · · · · · · · · · · · ║
╚═════════════════════════════════════════════════════╝