╔═════════════════════════════════════════════════════╗
║ · · · · · · · · · · · · · · · · · · · · · · · · · · ║
║ · ┌─────┐ · ┌───┐ · ┌─────────┐ · ┌───┐ · ┌─────┐ · ║
║ ■ │     │ · │   │ · │         │ · │   │ · │     │ ■ ║
║ · │     │ · └───┘ · └─────────┘ · └───┘ · │     │ · ║
║ · │     │ · · · · · · · · · · · · · · · · │     │ · ║
║ · │     │ · ┌─────────────────────────┐ · │     │ · ║
║ · └─────┘ · │ ┌─────────────────────┐ │ · └─────┘ · ║
║ · · · · · · │ │ · · · · · · · · · · │ │ · · · · · · ║
╚═════════╗ · │ │ · ┌─────────────┐ · │ │ · ╔═════════╝
          ║ · └─┘ · └─────────────┘ · └─┘ · ║          
          ║ · · · · · · · · · · · · · · · · ║          
          ║ · ┌─┐ · ╔═════   ═════╗ · ┌─┐ · ║          
══════════╝ · │ │ · ║             ║ · │ │ · ╚══════════
· · · · · · · │ │ · ║             ║ · │ │ · · · · · · ·
══════════╗ · │ │ · ║             ║ · │ │ · ╔══════════
          ║ · └─┘ · ╚═════════════╝ · └─┘ · ║          
          ║ · · · · · · · · · · · · · · · · ║          
          ║ · ┌───────┐ · ┌─┐ · ┌───────┐ · ║          
╔═════════╝ · └───────┘ · │ │ · └───────┘ · ╚═════════╗
║ ■ · · · · · · · · · · · │ │ · · · · · · · · · · · ■ ║
╙───┐ · ┌─┐ · ┌───────┐ · │ │ · ┌───────┐ · ┌─┐ · ┌───╜
╓───┘ · │ │ · └─────┐ │ · └─┘ · │ ┌─────┘ · │ │ · └───╖
║ · · · │ │ · · · · │ │ · · · · │ │ · · · · │ │ · · · ║
║ · ┌───┘ │ · ┌─┐ · │ └─────────┘ │ · ┌─┐ · │ └───┐ · ║
║ · │ ┌───┘ · └─┘ · └─────────────┘ · └─┘ · └───┐ │ · ║
║ · │ │ · · · · · · · · · · · · · · · · · · · · │ │ · ║
║ · │ │ · ┌─────────────────────────────────┐ · │ │ · ║
║ · └─┘ · └─────────────────────────────────┘ · └─┘ · ║
║ · · · · · · · · · · · · · · · · · · · · · · · · · · ║
╚═════════════════════════════════════════════════════╝